SWI SS1 SS1 SS1 SS1 SS1 SS1 SS2 SEI
EE1 XXX XXX XXX XXX XXX XXX XXX WW1
EE1 XXX NWO NN1 NEO XXX XXX XXX WW1
EE1 XXX WW1 XXX EE1 XXX XXX XXX WW1
EE1 XXX SWO SS1 SEO XXX XXX XXX WW1
EE1 XXX XXX XXX XXX XXX XXX XXX WW1
EE1 XXX XXX XXX XXX XXX XXX XXX WW1
EE1 XXX XXX XXX STA XXX XXX XXX WW1
EE2 XXX XXX XXX XXX XXX XXX XXX WW2
NWI NN1 NN1 NN1 NN1 NN1 NN1 NN2 NEI